#.#......######
#.####.########
#...##.########
##.###.......##
...#########.##
#####........##
.##.#####.#.###
.##.#######.###
